あい|愛|love
あいかわらず|相変わらず|as ever; as usual; the same
あいさつ|挨拶|greeting, salutation
あいじょう|愛情|love, affection
あいず|合図|sign, signal
アイスクリーム||ice cream
あいする|愛する|to love
あいて|相手|companion, partner, company
あいにく||unfortunately, Sorry,  but....
アイロン||(electric) iron
アウト||out
あかり|明かり|lamplight, light (in general), brightness
あき|空き|room, time to spare, emptiness
あきらか|明らか|obvious, evident, clear
あきらめる|諦める|to give up, to abandon
あきる|飽きる|to get tired of, to lose interest in
あきや|空き家|vacant house; unoccupied house
あくしゅ|握手|handshake
あくま|悪魔|devil, demon, evil spirit
あける|明ける|to dawn, to become daylight
あした||tomorrow
あしもと|足元|at one’s feet, under foot
あずける|預ける|to entrust, to deposit
あせ|汗|sweat, perspiration
あたえる|与える|to give, to present, to award
あたたか(い)|暖かい|warm, mild
あたり|辺り|vicinity, nearby
あたる|当たる|to be hit, to be successful||to be equivalent to
あたためる|温める|to warm, to heat
あちこち||here and there
あつかう|扱う|to handle, to deal with, to treat
あつまり|集まり|gathering, meeting,||assembly, collection
あてる|当てる|to hit, to apply a patch
あと|跡|(1) trace, tracks, mark, sign||(2) remains,ruins,(3) scar
あな|穴|hole
あびる|浴びる|to bathe, to shower||to bask in the sun
あぶら|油|oil
あまり|余り|not very, not much
あむ|編む|to knit, to braid
あやまり|誤り|error
あら|粗|defect, flaw, blemish, weak point
あらい|粗い|coarse; rough
あらし|嵐|storm, tempest
あらた|新た|new, fresh, novel
あらゆる||all, every
あらわす|表す|to express, to show, to reveal
あらわす|現す|to show, to indicate, to display
あらわれ|現れ|embodiment, materialization
あらわれる|現れる|(1) to appear, to become visible||(2) to express oneself
ありがとう||Thank you
ある|有る|to be, to have
ある|或|a certain..., some...
あるいは||or, possibly
アルバム||album
あわ|泡|bubble, foam, froth, head on beer
あわせる|合わせる|to join together, to match, to face
あわてる|慌てる|to panic, to rush
Hiragana|Kanji|Definitions
あわれ|哀れ|helpless, pity, sorrow, grief
あん|案|plan, suffix meaning draft
あんき|暗記|memorization, learning by heart
あんてい|安定|stability, equilibrium
あんない|案内|information, guidance, leading
あんなに||to that extent, to that degree
あんまり||not very, not much, remainder, rest
い|胃|stomach
いい||good
よい||good, nice, pleasant, ok
いいん|委員|committee member
ゆう|言う|to say
いがい|意外|unexpected, surprising
いき|行き|going
ゆき|行き|going
いき|息|breath, tone
いきおい|勢い|force, vigor, energy, spirit
いきもの|生き物|living thing, animal
いくつ|幾つ|how many?, how old?
いくら|幾ら|how much?, how many?
いけない||must not do, bad, wrong, not good
いし|医師|doctor, physician
いし|意思|intention, purpose
いし|意志|will, volition
いじ|維持|maintenance, preservation
いしき|意識|consciousness, senses
いじょう|異常|strangeness, abnormality, disorder
いす|椅子|chair
いずみ|泉|spring, fountain
いずれ||where, which, who
いぜん|以前|ago, since, before, previous
いた|板|board, plank
いだい|偉大|greatness
いだく|抱く|to embrace; to hold in the arms||to harbor
いたずら||tease, prank, trick, practical joke
いただきます||expression of gratitude before meals
いただく|頂く|to receive, to take food or drink (hum)
いたみ|痛み|pain, ache, sore, grief, distress
いたる|至る|to come, to arrive
いち|市|market, fair
いち|位置|place, situation, position, location
いちじ|一時|moment, time
いちどに|一度に|all at once
いちば|市場|(the) market (as a concept)
いちばん|一番|best, first, number one
いつか||sometime, someday, one day
いっか|一家|a family, a household
いっしゅ|一種|a species, a kind, a variety
いっしゅん|一瞬|a moment, an instant
いっしょう|一生|whole life, a lifetime, all through life
いっそう|一層|much more, still more, all the more
いったい|一体|(1) one object, one body||(2) what on earth?, really?
いっち|一致|(1) coincidence, agreement||(2) conformity
いつでも||always, at all times
いっぱん|一般|general, universal, ordinary, average
いっぽう|一方|on the other hand
いつまでも||forever, for good, eternally
いつも|いつも|always, usually, every time
いどう|移動|removal, migration, movement
いとこ|従兄弟|cousin (male)
いね|稲|rice-plant
いねむり|居眠り|dozing, nodding off
いのち|命|command, life, destiny
いはん|違反|violation, transgression, breach
いふく|衣服|clothes
いま|居間|living room (western style)
いまに|今に|before long, even now
いまにも|今にも|at any time, soon
いや|否|no, the noes
いらい|以来|since, henceforth
いらい|依頼|(1) request, commission, dispatch||(2) dependence, trust
いらいら||getting nervous, irritation
いらっしゃい||welcome
いりょう|医療|medical care, medical treatment
いわ|岩|rock, crag
いわい|祝い|celebration,festival
いわう|祝う|to congratulate, to celebrate
いわば|言わば|so to speak
いわゆる||the so-called, so to speak
インク||ink
いんさつ|印刷|printing
いんしょう|印象|impression
いんたい|引退|retire
いんよう|引用|quotation, citation
ウイスキー||whisky
うわ|上|upper, outer, surface
うお|魚|fish
うがい||gargle, rinse mouth
うかがう|伺う|(hon) to visit, to ask, to inquire
うけとる|受け取る|to receive, to get, to accept
うごかす|動かす|to move, to shift
うさぎ|兎|rabbit
うし|牛|cattle, cow
うしなう|失う|to lose, to part with
うしろ|後|afterwards, since then, in the future
うそ|嘘|lie
うたがう|疑う|to doubt
うち|内|inside
うちゅう|宇宙|universe, space
うつ|うつ|to attack, to defeat, to destroy
うつす|移す|to remove, to transfer
うったえる|うったえる|to sue (a person), to resort to||to appeal to
うなる|うなる|to groan, to moan
うばう|奪う|to snatch away
うま|馬|(1) horse, (2) promoted bishop (shogi)
うまい|うまい|delicious
うまれ|生まれ|birth, birth-place
うめ|梅|plum, plum-tree
うらぎる|裏切る|to betray
うるさい|うるさい|noisy, loud, fussy
うれしい|うれしい|happy, glad, pleasant
うれる|売れる|to be sold
うわさ|噂|rumour, report, gossip
うん|運|fortune, luck
うんてん|運転|operation, motion, driving
うんどう|運動|motion, exercise
え|柄|handle, grip
えいえん|永遠|eternity, immortality
えいきゅう|永久|eternity, immortality
えいきょう|影響|influence, effect
えいぎょう|営業|business, trade, management
えいせい|衛星|satellite
えいよう|栄養|nutrition, nourishment
えがお|笑顔|smiling face
えがく|描く|to draw, to paint
えさ|餌|feed, bait
エネルギー||energy
える|得る|to get, to gain, to win
うる|得る|to be able to ...; can ...
えん|円|circle, money
えんき|延期|postponement, adjournment
えんぎ|演技|acting, performance
えんじょ|援助|assistance, aid, support
エンジン||engine
えんぜつ|演説|speech, address
えんそう|演奏|musical performance
えんそく|遠足|excursion, outing, trip
えんりょ|遠慮|diffidence, restraint, reserve
お|御|honourable
おい|老い|old age, the old
おいつく|追い付く|to overtake, to catch up (with)
おう|王|king
おう|追う|to chase, to run after
おうさま|王様|king
おうじ|王子|prince
おうじる|応じる|to respond, to satisfy, to comply with
おうだん|横断|crossing
おえる|終える|to finish
おおいに|大いに|very, much, greatly
おおう|覆う|to cover, to wrap
オーバー||(1) overcoat, (2) over
おおや|大家|rich family, distinguished family
おか|丘|hill, rising ground
おき|沖|open sea
おく|奥|interior; inner part; depth
おくる|贈る|to send, to give to
おこる|起こる|to occur, to happen
おさない|幼い|very young, childish
おさめる|収める|to obtain, to pay, to supply
おじいさん||grandfather, male senior-citizen
おしゃべり||chattering, talk, idle talk
おせん|汚染|pollution, contamination
おそらく||perhaps
おそれる|恐れる|to fear, to be afraid of
おそろしい|恐ろしい|terrible, dreadful
おたがい|お互い|mutual, reciprocal, each other
おだやか|穏やか|calm, gentle, quiet
おとこのひと|男の人|man
おとる|劣る|to fall behind, to be inferior to
おなか|お腹|stomach
おに|鬼|ogre, demon
おび|帯|band (e.g. conduction, valence)
おひる|お昼|lunch, noon
オフィス||office
おぼれる|溺れる|to be drowned, to indulge in
おまえ||you (vulgar)
おめでとう||Congratulations!
おめにかかる|お目に掛かる|to meet (someone of higher status)
おもいで|思い出|memories, recollections
おもに|主に|mainly, primarily
おもわず|思わず|unintentional, spontaneous
おや|親|parents
およぎ|泳ぎ|swimming
およそ||about, roughly, approximately
およぼす|及ぼす|to exert, to cause
おる|居る|to be (animate), to be, to exist
おろす|下す|to lower, to let go down
おろす|降ろす|to take down, to launch, to drop
おわり|終|the end
おん|音|sound, note
おん|恩|favour, obligation, debt of gratitude
おんだん|温暖|warmth
おんど|温度|temperature
か|可|passable
か|課|lesson; section; division
カー||car
カード||card
かい|会|meeting, party, association, club
かい|回|counter for occurrences
がい|害|injury, harm, damage
かいいん|会員|member, the membership
かいが|絵画|picture
かいがい|海外|foreign, abroad, overseas
かいけい|会計|account, finance, accountant
かいけつ|解決|settlement, solution, resolution
かいごう|会合|meeting, assembly
がいこう|外交|diplomacy
かいし|開始|start, beginning
かいしゃく|解釈|explanation, interpretation
がいしゅつ|外出|outing, going out
がいしょく|外食|eating out, dining out
かいぜん|改善|betterment, improvement
かいてき|快適|pleasant, agreeable, comfortable
かいふく|回復|recovery, improvement, restoration
かう|飼う|to keep, to raise, to feed
かえる|替える|to exchange||(something with equivalent value)
かえる|換える|to replace
かおり|香り|aroma, fragrance, scent, smell
がか|画家|painter, artist
かかえる|抱える|to hold or carry under or in the arms
かかく|価格|price, value, cost
かがく|化学|chemistry
かがやく|輝く|to shine, to glitter, to sparkle
かかり|係|official, duty, person in charge
かかる|掛かる|to take (e.g. time, money, etc),to hang
かかる||to suffer from (e.g. sickness)
かぎ|鍵|key
かぎる|限る|to restrict, to limit, to confine
かく|描く|to draw, to paint, to sketch
かぐ|家具|furniture
がく|学|learning, scholarship, knowledge
がく|額|forehead, brow
かくご|覚悟|resolution, resignation
かくじつ|確実|certainty, reliability, soundness
がくしゃ|学者|scholar
がくしゅう|学習|study, learning
かくす|隠す|to hide something
かくだい|拡大|magnification, enlargement
かくにん|確認|affirmation, confirmation
がくぶ|学部|department of a university
がくもん|学問|scholarship, study, learning
かくれる|隠れる|to hide, to be hidden
かげ|影|shade, shadow, other side
かげ|陰|shade, shadow, other side
かける|欠ける|to be lacking
かげん|加減|addition and subtraction
かこ|過去|the past, bygone days, the previous
かご|籠|basket, cage
かこむ|囲む|to surround, to encircle
かさい|火災|conflagration, fire
かし|貸し|loan, lending
かし|菓子|pastry
かじ|家事|housework, domestic chores
かしこい|賢い|wise, clever, smart
かしゅ|歌手|singer
かず|数|number, figure
かせぐ|稼ぐ|to earn income, to labor
かぞえる|数える|to count
かた|型|mold, model, style
かた|肩|shoulder
かたい|硬い|solid, hard
かたがた|方々|persons, they (of people)
かたな|刀|sword, saber, knife
かたる|語る|to talk, to tell, to recite
かち|勝ち|win, victory
かち|価値|value, worth, merit
がっかり||feel disappointed, be dejected
かっき|活気|energy, liveliness
がっき|学期|term (school)
かっこう|格好|shape, form, posture
かつどう|活動|action, activity
かつよう|活用|conjugation, practical use
かなしむ|悲しむ|to be sad, to mourn for, to regret
かならずしも|必ずしも|(not) always, (not) necessarily
かなり||considerably, fairly, quite
かね|金|(1) gold, (2) gold general (shogi)
かねもち|金持ち|rich man
かのう|可能|possible, practicable, feasible
かぶ|株|share, stock, stump (of tree)
かぶる|被る|to put on (one's head) ||to be covered with
かまう|構う|to mind, to care about
がまん|我慢|patience, endurance, perseverance
かみ|上|(1) first volume, (2) superior quality||(3) governmental
かみ|神|god
かみがた|髪型|hair style
かみなり|雷|thunder
かみのけ|髪の毛|hair (head)
かもく|科目|(school) subject, curriculum, course
かもしれない||may, might, perhaps, possibly
かよう|火曜|(abbr) Tuesday
から|空|emptiness; vacuum; blank
がら|柄|hilt (of a sword), haft (of a dagger)
かる|刈る|to cut (hair), to mow
かれら|彼等|they (usually male)
かわ|川|river
かわ|河|river, stream
かわ|皮|skin, hide, leather, fur, pelt, bark
かわ|革|leather
かわいそう||poor, pitiable, pathetic
かわいらしい||lovely, sweet
かん|缶|can, tin
かん|勘|perception, intuition, the sixth sense
かんがえ|考え|thinking, thought, ideas, intention
かんかく|感覚|sense, sensation
かんきゃく|観客|audience, spectator(s)
かんきょう|環境|environment, circumstance
かんげい|歓迎|welcome, reception
かんこう|観光|sightseeing
かんさつ|観察|observation, survey
かんじ|感じ|feeling, sense, impression
かんしゃ|感謝|thanks, gratitude
かんじゃ|患者|a patient
かんじょう|勘定|calculation, counting, consideration
かんじょう|感情|emotion(s), feeling(s), sentiment
かんじる|感じる|to feel, to sense, to experience
かんしん|感心|admiration, Well done!
かんしん|関心|concern, interest
かんする|関する|to concern, to be related
かんせい|完成|(1) complete, completion||(2) perfection, accomplishment
かんぜん|完全|perfection, completeness
かんどう|感動|being deeply moved
かんとく|監督|supervision
かんり|管理|management (e.g. of a business)
かんりょう|完了|completion, conclusion
かんれん|関連|relation, connection, relevance
ぎいん|議員|member of the Congress
きおく|記憶|memory, recollection, remembrance
きおん|気温|temperature
きかい|機械|machine, mechanism
ぎかい|議会|Diet, congress, parliament
きかん|期間|period, term
きかん|機関|organ, mechanism, facility,engine
きぎょう|企業|enterprise, undertaking
きく|効く|to be effective
きげん|機嫌|humour, temper, mood
きこう|気候|climate
きし|岸|bank, coast, shore
きじ|生地|cloth; fabric; dough
きじ|記事|article, news story, report
ぎし|技師|engineer, technician
きしゃ|記者|reporter
きず|傷|wound, injury, hurt, cut
きたい|期待|expectation, anticipation, hope
きたく|帰宅|returning home
きちょう|貴重|precious, valuable
ぎちょう|議長|chairman
きちんと||precisely, accurately
きつい||tight, close, intense
きづく|気付く|to notice, to recognize
きにいる|気に入る|to like; to be pleased with
きにゅう|記入|entry, filling in of forms
きねん|記念|commemoration, memory
きのう|機能|function, faculty
きのどく|気の毒|pitiful, a pity
きふ|寄付|contribution, donation
きぼう|希望|hope, wish, aspiration
きほん|基本|foundation, basis, standard
きまり|決まり|settlement, regulation, rule
きみ|気味|-like, -looking, -looked
きみょう|奇妙|strange, queer, curious
ぎむ|義務|duty, obligation, responsibility
ぎもん|疑問|question, doubt, suspicion
ぎゃく|逆|reverse, opposite
キャプテン||captain
キャンプ||camp
きゅう|九|nine
きゅう|旧|ex-
きゅう|級|class, grade, rank
きゅう|球|globe, sphere, ball
きゅうか|休暇|holiday, day off
きゅうけい|休憩|rest, break, recess
きゅうげき|急激|sudden; abrupt
きゅうしゅう|吸収|absorption, suction, attraction
きゅうじょ|救助|relief, aid, rescue
きゅうそく|急速|rapid (e.g. progress)
きゅうに|急に|rapidly; suddenly
きゅうりょう|給料|salary, wages
きよう|器用|skillful, handy
きょうかしょ|教科書|text book
きょうぎ|競技|game, match, contest
ぎょうぎ|行儀|manners
きょうきゅう|供給|supply, provision
きょうし|教師|teacher (classroom)
きょうじゅ|教授|teaching, instruction, professor
きょうちょう|強調|emphasis, stress, stressed point
きょうつう|共通|commonness, community
きょうどう|共同|cooperation, collaboration
きょうふ|恐怖|fear, dread, terror
きょうりょく|協力|cooperation, collaboration
きょうりょく|強力|powerful; strong
きょか|許可|permission, approval
きょく|局|bureau; department
きょだい|巨大|huge, gigantic, enormous
きらう|嫌う|to hate, to dislike
きり|霧|fog, mist
きれ|切れ|cloth, piece, cut, chop
きれる|切れる|(1) to cut well, to be sharp||(2) to break (off)
キロ||(abbr) kilo-, kilogram, kilometre
きろく|記録|record, minutes, document
ぎろん|議論|argument, discussion, dispute
きん|金|gold
ぎん|銀|silver
きんえん|禁煙|No Smoking!
きんがく|金額|amount of money
きんこ|金庫|safe, vault
きんし|禁止|prohibition, ban
きんせん|金銭|money, cash
きんぞく|金属|metal
きんだい|近代|present day
きんちょう|緊張|tension, mental strain, nervousness
きんにく|筋肉|muscle
きんゆう|金融|monetary circulation, credit situation
きんよう|金曜|(abbr) Friday
く|九|nine
く|句|sentence; passage; paragraph
くう|食う|(male) (vulg) to eat
ぐうぜん|偶然|(by) chance, unexpectedly, suddenly
くさい|臭い|stinking; smelly
くさり|鎖|chain
くさる|腐る|to rot, to go bad
くせ|癖|a habit
くだ|管|pipe, tube
ぐたい|具体|concrete, tangible, material
ぐたいてき|具体的|concrete; definite; specific
くださる|下さる|(hon) to give, to confer
くだり|下り|down-slope; train heading toward ||the ending point of its route
くつう|苦痛|pain, agony
ぐっすり||sound asleep, fast asleep
くべつ|区別|distinction, classification
くみ|組|class, group, team, set
くみあい|組合|association, union
くむ|組む|to put together
くもり|曇|cloudiness, cloudy weather, shadow
くらい|位|grade, rank, about
くらし|暮らし|living, livelihood
クラシック||classic(s)
くらす|暮らす|to live, to get along
グラス||(1) glass, (2) grass
グランド||gland, grand, (electrical) ground
クリーム||cream
くりかえす|繰り返す|to repeat, to do something over again
クリスマス||Christmas
くるう|狂う|to go mad, to get out of order
グループ||group
くるしい|苦しい|painful, difficult
くるしむ|苦しむ|to suffer, to groan, to be worried
くれ|暮れ|year end, sunset, nightfall, end
くろう|苦労|troubles, hardships
くわえる|加える|to append, to sum up, to add (up)
くわしい|詳しい|knowing very well, detailed
くわわる|加わる|to join in
くん|訓|native Japanese reading||of a Chinese character
ぐん|軍|army, force, troops
ぐんたい|軍隊|army, troops
くんれん|訓練|practice, training
げ|下|under, below, beneath
けい|計|plan
けいい|敬意|respect, honour
けいえい|経営|management, administration
けいかく|計画|plan, project, schedule, scheme
けいき|景気|condition, state, business (condition)
けいけん|経験|experience
けいこう|傾向|tendency,  trend, inclination
けいこく|警告|warning, advice
けいさん|計算|calculation, reckoning
けいじ|掲示|notice, bulletin
けいじ|刑事|criminal case, (police) detective
げいじゅつ|芸術|(fine) art, the arts
けいやく|契約|contract, compact, agreement
けいゆ|経由|go by the way,  via
ケース||case
ゲーム||game
けが|怪我|injury (to animate object), hurt
げき|劇|drama, play
げきじょう|劇場|theatre, playhouse
けしょう|化粧|make-up (cosmetic)
けち||stinginess, miser, miserliness
けっか|結果|result, consequence
けっかん|欠陥|defect, fault, deficiency
けっきょく|結局|after all, eventually
けっしん|決心|determination, resolution
けっせき|欠席|absence, non-attendance
けってい|決定|decision, determination
けってん|欠点|faults, defect, weakness
げつよう|月曜|Monday
けつろん|結論|conclusion
けむり|煙|smoke, fumes
けん|券|ticket, coupon
けん|県|prefecture
けん|軒|eaves
けんか|喧嘩|quarrel, (drunken) brawl
けんかい|見解|opinion, point of view
げんかい|限界|limit, bound
げんきん|現金|cash, ready money
げんご|言語|language
けんこう|健康|health, sound, wholesome
けんさ|検査|inspection, examination
げんざい|現在|present, up to now, current
げんじつ|現実|reality
げんしょう|現象|phenomenon
げんじょう|現状|present condition, existing state
けんせつ|建設|construction, establishment
げんだい|現代|nowadays, modern times, present-day
けんちく|建築|construction, architecture
けんとう|見当|aim, estimate, guess
けんとう|検討|consideration, investigation
げんば|現場|actual spot, scene, scene of the crime
けんぽう|憲法|constitution
けんり|権利|right, privilege
ご|後|afterwards, since then, in the future
ご|語|language, word
こい|恋|love, tender passion
こい|濃い|thick, dense, strong
こいびと|恋人|lover, sweetheart
こううん|幸運|good luck, fortune
こうえん|講演|lecture, address
こうか|効果|effect, effectiveness
こうか|硬貨|coin
こうか|高価|high price
ごうか|豪華|gorgeous, extravagance
ごうかく|合格|success, passing (e.g. exam)
こうかん|交換|exchange, interchange
こうくう|航空|aviation, flying
こうけい|光景|scene, spectacle
ごうけい|合計|sum total, total amount
こうげき|攻撃|attack, strike
こうけん|貢献|contribution, services
こうこく|広告|advertisement
こうさい|交際|company, friendship, association
こうしゃ|後者|the latter
こうば|工場|factory, plant
こうせい|構成|organization, composition
こうそく|高速|high speed, high gear
こうどう|行動|action, conduct, behaviour
ごうとう|強盗|robbery, burglary
こうふく|幸福|happiness, blessedness
こうへい|公平|fairness, impartial, justice
こうほ|候補|candidate; prospect
こうりょ|考慮|consideration, taking into account
こえる|越える|to exceed, to cross over
コーチ||coach
コード||code, cord
こおり|氷|ice, hail
こおる|凍る|to freeze, to be frozen
ゴール||goal
ごかい|誤解|misunderstanding
ごがく|語学|language study
こきゅう|呼吸|breath, respiration
こきょう|故郷|home town, birthplace
ごく|極|pole; climax; extreme
こくご|国語|national language
こくばん|黒板|blackboard
こくふく|克服|subjugation, conquest
こくみん|国民|national, people, citizen
こくもつ|穀物|grain, cereal, corn
ここ|ここ|here
こし|腰|hip
こしょう|故障|break-down, failure, out of order
こじん|個人|individual, personal
こす|越す|to go over (e.g. with audience)
こっか|国家|state, country, nation
こっかい|国会|National Diet, parliament, congress
こっきょう|国境|national or state border
こっせつ|骨折|bone fracture
こづつみ|小包|parcel, package
こと|事|thing, matter, fact
ことなる|異なる|to differ, to vary, to disagree
ことわざ|諺|proverb, maxim
ことわる|断る|to refuse, to decline
こな|粉|flour, meal, powder
この|この|this
このみ|好み|liking, taste, choice
このむ|好む|to like, to prefer
コピー||a copy
ごみ|塵|dust, dirt
こむぎ|小麦|wheat
ごめんなさい||I beg your pardon, excuse me
こや|小屋|hut, cabin, shed
これら||these
ころ|頃|time, about, approximately (time)
ころす|殺す|to kill
ころぶ|転ぶ|to fall down, to fall over
こんかい|今回|now, this time, lately
こんご|今後|from now on, hereafter
こんざつ|混雑|confusion, congestion
こんなに||like this, in this way
こんなん|困難|difficulty, distress
こんにち|今日|today, this day
こんにちは||hello
コンピューター||computer
こんやく|婚約|engagement, betrothal
こんらん|混乱|disorder, chaos, confusion
さ|差|difference, variation
サービス||service
さい|際|on the occasion of, circumstances
さいこう|最高|highest, supreme, the most
ざいさん|財産|property, fortune, assets
さいしゅう|最終|last, final, closing
さいちゅう|最中|in the middle of
さいてい|最低|least, lowest, worst
さいのう|才能|talent, ability
さいばん|裁判|trial, judgement
ざいりょう|材料|ingredients, material
さいわい|幸い|happiness, blessedness
サイン||(1) autograph, (2) sign, (3) sine
さかい|境|border, boundary, mental state
さからう|逆らう|to go against, to oppose
さかり|盛り|helping, serving
さぎょう|作業|work, operation
さく|昨|last (year), yesterday
さくひん|作品|work, performance, production
さくもつ|作物|produce (e.g. agricultural), crops
さくら|桜|cherry blossom, cherry tree
さけ|酒|alcohol, sake
さけぶ|叫ぶ|to shout, to cry
さける|避ける|to avoid
ささえる|支える|to support; to hold up
さす|指す|to point; to specify some person
ざせき|座席|seat
さそう|誘う|to invite; to induce
さつ|札|bill; paper money
さっか|作家|author, writer, novelist
さっきょく|作曲|composition
ざっと||roughly, in round numbers
さっぱり||feeling refreshed, feeling relieved
さて||well, now, then
さばく|砂漠|desert
さべつ|差別|discrimination
さほう|作法|manners, etiquette, propriety
さまざま|様々|varied, various
さます|覚ます|to awaken
さめる|覚める|to wake, to wake up
さゆう|左右|left and right
さら|皿|plate, dish
さらに|更に|furthermore, again, moreover
さる|去る|to leave, to go away
さる|猿|monkey
さわぎ|騒ぎ|uproar, disturbance
さんか|参加|participation
さんこう|参考|reference, consultation
さんせい|賛成|approval, agreement, support
さんそ|酸素|oxygen
さんぽ|散歩|walk, stroll
し|四|four
し|氏|family name, lineage, birth
し|詩|poem, verse of poetry
しあわせ|幸せ|happiness, good fortune
ジーンズ||jeans
ジェットき|ジェット機|jet aeroplane
じかに|直に|immediately, readily, directly
しかも||moreover, furthermore
しかる|叱る|to scold
しき|式|equation, formula, ceremony
じき|直|earnestly, immediately, exactly
じき|時期|time, season, period
しきゅう|支給|payment, allowance
しきりに||frequently, repeatedly
しげき|刺激|stimulus, impetus, incentive
しげん|資源|resources
じけん|事件|event, affair, incident
じこく|時刻|instant, time, moment
じさつ|自殺|suicide
じじつ|事実|fact, truth, reality
ししゅつ|支出|expenditure, expenses
じじょう|事情|circumstances, conditions
しじん|詩人|poet
じしん|自身|by oneself, personally
しずむ|沈む|to sink, to feel depressed
しぜん|自然|nature, spontaneous
しそう|思想|thought, idea
した|舌|tongue
しだい|次第|(1)order, precedence ||(2) circumstances
じたい|事態|situation, present state of affairs
したがう|従う|to obey, to follow
したがって|したがって|therefore, consequently
したく|支度|preparation
したしい|親しい|intimate, close (e.g. friend)
しち|七|seven
しつ|質|quality, nature (of person)
しつぎょう|失業|unemployment
じっけん|実験|experiment
じつげん|実現|implementation, realization
じっこう|実行|practice, execution, realization
じっさい|実際|practical, actual condition
じっし|実施|enforcement, to put into practice
じっと||firmly, patiently, quietly
じつに|実に|indeed, truly, surely
じつは|実は|as a matter of fact, by the way
しつぼう|失望|disappointment, despair
してん|支店|branch store (office)
しどう|指導|leadership, guidance, coaching
じどう|自動|automatic, self-motion
しな|品|thing, goods
しはい|支配|rule, control, direction
しばい|芝居|play, drama
しばしば||often, frequently
しばふ|芝生|lawn
しはらい|支払|payment
しはらう|支払う|to pay
しぼう|死亡|death, mortality
しほん|資本|funds, capital
しまい|姉妹|sisters
しまう|しまう|to finish, to do something completely
しまった|しまった|darn it!; darn!; oops!
じまん|自慢|pride, boast
じむ|事務|business, office work
しめす|示す|to show, to point out
しめる|占める|(1) to comprise, to make up (of)||(2) to hold, to occupy
しも|下|under, below, beneath
しも|霜|frost
じゃあ||well, well then
しゃっきん|借金|debt, loan, liabilities
しゃべる||to talk, to chat, to chatter
じゃま|邪魔|hindrance, intrusion
しゅう|週|week
しゅう|州|sandbank
じゅう|十|10, ten
じゅう|銃|gun
しゅうい|周囲|surroundings, circumference, environs
しゅうかく|収穫|harvest, crop
しゅうかん|週間|week, weekly
しゅうきょう|宗教|religion
じゅうし|重視|importance, stress,||serious consideration
しゅうしょく|就職|finding employment
ジュース||juice, soft drink
しゅうせい|修正|amendment, correction, modification
じゅうたい|渋滞|traffic jam, delay, stagnation
じゅうだい|重大|serious, important, grave
じゅうたく|住宅|resident, housing
しゅうだん|集団|group, mass
しゅうちゅう|集中|concentration, focusing the mind
しゅうにゅう|収入|income, receipts, revenue
じゅうみん|住民|citizens, inhabitants, residents
じゅうよう|重要|important, essential, principal
しゅうり|修理|repairing, mending
しゅぎ|主義|doctrine, rule, principle
しゅくはく|宿泊|lodging
しゅじゅつ|手術|surgical operation
しゅしょう|首相|Prime Minister
しゅだん|手段|means, way, measure
しゅちょう|主張|claim, request, assertion
しゅっしん|出身|graduate from, come from
しゅっせき|出席|attendance, presence
しゅっぱつ|出発|departure
しゅっぱん|出版|publication
しゅと|首都|capital city
しゅふ|主婦|housewife, mistress
しゅよう|主要|chief, main, principal, major
じゅよう|需要|demand, request
しゅるい|種類|variety, kind, type
じゅん|順|order, turn
しゅんかん|瞬間|moment, second, instant
じゅんちょう|順調|favourable, doing well
じゅんばん|順番|turn (in line), order of things
じゅんび|準備|preparation, arrangements
しよう|使用|use, application, utilization
しょう|小|smallness; small item
しょう|章|chapter, section
しょう|賞|prize, award
じょう|上|(1) first volume, (2) superior quality
しょうがい|障害|obstacle, impediment (fault)
しょうがくきん|奨学金|scholarship
じょうきゃく|乗客|passenger
じょうきょう|上京|proceeding to the capital (Tokyo)
じょうきょう|状況|situation, circumstances
じょうけん|条件|conditions, terms
しょうご|正午|noon, mid-day
しょうじき|正直|honesty, integrity, frankness
じょうしき|常識|common sense
しょうじょ|少女|young lady, little girl
しょうしょう|少々|just a minute, small quantity
しょうじょう|症状|symptoms, condition
しょうじる|生じる|to produce, to result from, to arise
しょうたい|招待|invitation
じょうたい|状態|condition, situation, state
じょうたつ|上達|improvement, advance, progress
じょうだん|冗談|jest, joke
しょうち|承知|consent, acceptance, assent
じょうとう|上等|superiority, first class, very good
しょうとつ|衝突|collision, conflict
しょうにん|商人|trader, shopkeeper, merchant
しょうにん|承認|recognition, acknowledgement, approval
しょうねん|少年|boys, juveniles
しょうばい|商売|trade, business, commerce
しょうひ|消費|consumption, expenditure
しょうひん|商品|goods, merchandise
しょうぼう|消防|fire fighting, fire department
じょうほう|情報|information
しょうめい|証明|proof, verification
じょおう|女王|queen
しょく|職|employment
しょくぎょう|職業|occupation, business
しょくじ|食事|meal
しょくたく|食卓|dining table
しょくひん|食品|commodity, foodstuff
しょくぶつ|植物|plant, vegetation
しょくもつ|食物|food, foodstuff
しょくよく|食欲|appetite (for food)
しょくりょう|食料|food
しょくりょう|食糧|provisions, rations
しょさい|書斎|study
じょし|女子|woman, girl
じょしゅ|助手|helper, assistant, tutor
じょじょに|徐々に|slowly, little by little, gradually
しょめい|署名|signature
しょもつ|書物|books
じょゆう|女優|actress
しょり|処理|processing, dealing with, treatment, disposal
しょるい|書類|documents, official papers
しらせ|知らせ|notice
しり|尻|buttocks, bottom
しるし|印|mark; symbol; evidence
しろ|城|castle
しんがく|進学|going on to university
しんけい|神経|nerve, sensitivity
しんけん|真剣|seriousness, earnestness
しんこう|信仰|(religious) faith, belief, creed
しんごう|信号|traffic lights, signal
じんこう|人工|artificial, manmade
しんこく|深刻|serious
しんさつ|診察|medical examination
じんしゅ|人種|race (of people)
しんじる|信じる|to believe
じんせい|人生|(human) life (i.e. conception to death)
しんせき|親戚|relative
しんせん|新鮮|fresh
しんぞう|心臓|heart
しんたい|身体|the body
しんちょう|身長|height (of body), stature
しんちょう|慎重|discretion, prudence
しんぱい|心配|worry, concern, anxiety
しんぱん|審判|trial, judgement, referee
じんぶつ|人物|character, personality, person
しんぽ|進歩|progress, development
しんゆう|親友|close friend, buddy
しんよう|信用|confidence, dependence, credit, faith
しんらい|信頼|reliance, trust, confidence
しんり|心理|mentality
じんるい|人類|mankind, humanity
す|巣|nest
ず|図|figure (e.g. Fig 1),picture, illustration
すいじゅん|水準|(1) water level||(2) level, standard
すいせん|推薦|recommendation
スイッチ||switch
ずいぶん|随分|extremely
すいみん|睡眠|sleep
すう|数|number, figure
すうじ|数字|numeral, figure
スープ||(Western) soup
すえ|末|the end of, powder
すがた|姿|figure, shape, appearance
スキー||skiing
すく|空く|(1) to open, to become empty||(2) to be less crowded
すくう|救う|to rescue from, to help out of
すぐれる|優れる|to surpass, to outstrip, to excel
スケート||skate(s), skating
すごい||terrific, amazing, great
すこしも|少しも|anything of, not one bit
すごす|過ごす|to pass, to spend, to go through
すじ|筋|muscle, string, line
すすめる|進める|to advance, to promote ,to hasten
すすめる|勧める|to recommend, to encourage
スター||star
スタイル||style
スタンド||stand
ずつう|頭痛|headache
ずっと||consecutively, throughout, a lot
すてき||lovely, dreamy, beautiful, great
すでに|既に|already, too late
すなわち||that is, namely, i.e.
すばらしい|素晴らしい|wonderful, splendid, magnificent
スピーチ||speech
すべて|全て|all, the whole, entirely
すませる|済ませる|to be finished
すみ|角|horn
する||to do; to carry out; to perform
すると|すると|thereupon, hereupon
するどい|鋭い|pointed, sharp
せい|背|height, stature
せい|正|(logical) true, regular
せい|生|(1) draft (beer) ||(2) raw, unprocessed
せい|性|sex, gender
せい|所為|cause, reason, fault
ぜい|税|tax
せいかく|性格|character, personality
せいかく|正確|accurate, exactness
せいき|世紀|century, era
せいきゅう|請求|claim, demand, charge, billing
ぜいきん|税金|tax, duty
せいけつ|清潔|clean
せいげん|制限|restriction, restraint, limitation
せいこう|成功|success, hit
せいさん|生産|production, manufacture
せいしき|正式|official, formality
せいしん|精神|mind, soul, spirit
せいじん|成人|adult
せいぜい|精々|at the most, at best
せいせき|成績|results, record
せいぞう|製造|manufacture, production
ぜいたく|贅沢|luxury, extravagance
せいちょう|成長|growth, grow to adulthood
せいど|制度|system, institution, organization
せいねん|青年|youth, young man
せいひん|製品|manufactured goods, finished goods
せいふ|政府|government, administration
せいぶつ|生物|raw food
せいめい|生命|life, existence
せいり|整理|sorting, arrangement, adjustment
せき|咳|cough
せきたん|石炭|coal
せきにん|責任|duty, responsibility
せきゆ|石油|oil, petroleum, kerosene
せけん|世間|world, society
せつ|説|theory
せっきょくてき|積極的|positive, active, proactive
せっけい|設計|plan, design
ぜったい|絶対|absolute, unconditional, absoluteness
セット||set
せつび|設備|equipment, device,||facilities, installation
ぜつめつ|絶滅|destruction, extinction
せつやく|節約|economising, saving
ぜひ|是非|certainly, without fail
せめる|責める|to condemn, to blame, to criticize
せわ|世話|looking after, help, aid, assistance
ぜん|善|good, goodness, right, virtue
ぜん|全|all, whole, entire, complete
ぜんいん|全員|all members (unanimity),||all hands,the whole crew
せんこう|専攻|major subject, special study
ぜんこく|全国|country-wide, nation-wide
せんじつ|先日|the other day, a few days ago
ぜんしゃ|前者|the former
せんしゅ|選手|player (in game)
ぜんしん|前進|advance, drive, progress
ぜんぜん|全然|(1) wholly, entirely, completely||(2) not at all (with neg. verb)
センター||a center
ぜんたい|全体|whole, entirety
せんたく|選択|selection, choice
そう|そう|so
ぞう|象|elephant
そうおん|騒音|noise
ぞうか|増加|increase, addition
そうさ|操作|operation, management, processing
そうじ|掃除|cleaning, sweeping
そうぞう|想像|imagination, guess
そうぞく|相続|succession, inheritance
そうだん|相談|consultation, discussion
そうち|装置|equipment, installation, apparatus
そうとう|相当|suitable, being equivalent to
そくど|速度|speed, velocity, rate
そこ|底|bottom, sole
そこで||so (conj), accordingly, now, then
そしき|組織|organization, structure,  tissue
そして||and
そそぐ|注ぐ|to pour into
そだつ|育つ|to be raised (e.g. child);||to be brought up; to grow (up)
そっくり||all, altogether; be just like
そっと||face of the earth
そで|袖|sleeve
そなえる|備える|to furnish, to equip; to prepare for
その|その|the, that
そのうち||eventually, sooner or later
そのまま||without change, as it is
そば|側|side, edge, third person
ソファー||sofa, couch
そまつ|粗末|rough, plain, humble
それぞれ||each, respectively
それでも||but (still), and yet, even so
それとも||or, or else
そん|損|loss, disadvantage
そんがい|損害|damage, injury, loss
そんけい|尊敬|respect, esteem, honour
そんざい|存在|existence, being
そんちょう|尊重|respect, esteem, regard
た|田|rice field
た|他|other (esp. places and things)
たい|対|opposite; opposition; versus
だい|大|large; big; great
だい|台|stand, rack, table
だい|題|title, subject, theme, topic
たいいく|体育|physical education, gymnastics
たいおん|体温|temperature (body)
たいか|大家|master; expert
たいかい|大会|convention, tournament
たいき|大気|atmosphere
だいきん|代金|price, payment, charge
たいくつ|退屈|tedium, boredom
たいざい|滞在|stay
たいし|大使|ambassador
たいした|大した|considerable, great, significant
たいしょう|対象|target, object (of worship, study, etc),||subject (of taxation, etc)
だいじん|大臣|cabinet minister
たいする|対する|to face, to confront, to oppose
たいせん|大戦|great war, great battle
たいてい|大抵|usually, generally
たいど|態度|attitude, manner
だいとうりょう|大統領|president, chief executive
たいはん|大半|majority, mostly, generally
だいひょう|代表|representative, representation
だいひょうしゃ|代表者|representative
だいぶぶん|大部分|most part, greater part, majority
タイプライター||typewriter
たいへん|大変|awful, dreadful, terrible
たいほ|逮捕|arrest, apprehension, capture
ダイヤ||(railway) schedule; diamond
たいよう|太陽|sun, solar
たいら|平ら|flatness, level, smooth
だいり|代理|representation, agency ,proxy
たいりく|大陸|continent
たおす|倒す|to throw down, to beat, to bring down
タオル||(hand) towel
だが|だが|but; however; (and) yet
たがい|互い|mutual, reciprocal
たから|宝|treasure
だから|だから|so, therefore
たく|宅|house, home, husband
だけど||however
たしかめる|確かめる|to ascertain
たしょう|多少|more or less, somewhat
たすける|助ける|to help, to save, to rescue
ただ||free of charge, mere, only
ただ|只|ordinary; common; usual
たたかい|戦い|battle, fight, conflict
たたかう|戦う|to fight, to battle, to combat
たたく|叩く|to strike, to clap, to beat
ただちに|直ちに|at once, immediately
たちあがる|立ち上がる|to stand up
たちば|立場|standpoint, position, situation
たつ|経つ|to pass, to lapse
たっする|達する|to reach, to get to
たった|唯|only; merely; but; no more than
だって||but, because, even
たっぷり||full, in plenty, ample
たて|縦|length, height
たとえ||simile, metaphor, allegory
たに|谷|valley
たにん|他人|another person, outsider, stranger
たね|種|seed; cause; source
たば|束|handbreadth, bundle
たび|度|counter for occurrences
たび|旅|travel, trip, journey
たびたび||often, repeatedly, frequently
たぶん|多分|perhaps, probably
たま|玉|ball, sphere, coin
たま|球|globe, sphere, ball
たま|弾|bullet, shot, shell
たま|偶|occasional; infrequent; rare
たまたま|偶々|unexpectedly, accidentally, by chance
たまらない||intolerable, unbearable, unendurable
だまる|黙る|to be silent
だめ|駄目|useless, no good, hopeless
ためし|試し|trial, test
ためす|試す|to attempt, to test
たより|便り|news, tidings, letter
たよる|頼る|to rely on, to depend on
だれか|誰か|someone, somebody
だん|段|step, grade, rank, level
たんい|単位|unit, credit (in school)
たんご|単語|word, vocabulary
だんし|男子|youth, young man
たんじゅん|単純|simplicity
たんじょう|誕生|birth
ダンス||dance
だんたい|団体|organization, association
たんとう|担当|(in) charge
たんなる|単なる|mere, simple, sheer
たんに|単に|simply, merely, only, solely
ち|地|earth
ちい|地位|(social) position, status
ちいき|地域|area, region
チーズ||cheese
チーム||team
ちえ|知恵|wisdom, wit, intelligence
ちか|地下|basement, underground
ちがい|違い|difference, discrepancy
ちがいない|違いない|no mistaking it, for certain
ちかごろ|近頃|lately, recently, nowadays
ちかみち|近道|short way, shortcut
ちからづよい|力強い|powerful, strong
ちきゅう|地球|the earth
ちく|地区|district, section, sector
ちこく|遅刻|lateness, late coming
ちじ|知事|prefectural governor
ちしき|知識|knowledge, information
ちちおや|父親|father
ちのう|知能|intelligence, brains
ちへいせん|地平線|horizon
ちほう|地方|area, region
ちゃ|茶|tea
チャンス||chance, opportunity
ちゃんと||perfectly, properly, exactly
ちゅう|中|inside, middle, among
ちゅう|注|annotation, explanatory note
ちゅうおう|中央|central, center, middle
ちゅうがく|中学|middle school, junior high school
ちゅうかん|中間|middle, midway, center
ちゅうこ|中古|used, second-hand, old
ちゅうし|中止|suspension, discontinuance,||interruption
ちゅうしゃ|駐車|parking (e.g. car)
ちゅうしょく|昼食|lunch, midday meal
ちゅうしん|中心|center, core, heart
ちゅうしんち|中心地|center, metropolis
ちゅうもく|注目|notice, attention, observation
ちゅうもん|注文|order, request
ちょうき|長期|long time period
ちょうさ|調査|investigation, examination, survey
ちょうし|調子|tune, tone
ちょうしょ|長所|strong point, merit, virtue
ちょうじょう|頂上|top, summit, peak
ちょうだい||receiving; reception;||please; please do for me
ちょきん|貯金|(bank) savings
ちょくせつ|直接|direct, immediate, firsthand
ちょしゃ|著者|author, writer
ついに|遂に|finally, at last
つうか|通過|passage through, passing
つうがく|通学|commuting to school
つうこう|通行|passage, passing
つうじる|通じる|to lead to, to understand
つうしん|通信|communication, news, signal
つかまる|捕まる|to be caught, to be arrested
つかむ|掴む|to seize, to catch, to grasp
つかれ|疲れ|tiredness, fatigue
つき|月|moon, month
つきあい|付き合い|association, socializing, fellowship
つぎつぎ|次々|in succession, one by one
つく|就く|to settle in (place), to take (seat, position)
つぐ|注ぐ|to pour (into), to irrigate, to pay
つける|付ける|to attach, to append
つち|土|earth, soil
つづき|続き|sequel, continuation
つつみ|包み|bundle, package, parcel
つとめ|勤め|duty, business, responsibility, task
つとめ|務め|service, duty
つなぐ|繋ぐ|to tie, to connect, to transfer a call
つねに|常に|always, constantly
つばさ|翼|wings
つまり||in short, in brief, in other words
つみ|罪|crime, fault, indiscretion
つめる|詰める|to pack
つもる|積もる|to pile up
つゆ|梅雨|rainy season in Japan
つらい|辛い|painful, heart-breaking
つり|釣|fishing
つれ|連れ|companion, company
で|出|outflow, coming (going) out;||origins, originating from
であい|出会い|meeting, rendezvous, encounter
であう|出会う|to come across, to encounter
ていあん|提案|proposal, proposition, suggestion
ていき|定期|fixed term
ていこう|抵抗|resistance, opposition
ていしゅつ|提出|presentation, submission, filing
ていど|程度|degree, amount, grade, standard
ていりゅうじょ|停留所|bus or tram stop
デート||date, go on a date
てき|敵|enemy, rival
できごと|出来事|incident, affair, happening, event
てきする|適する|to fit, to suit
てきせつ|適切|pertinent, appropriate, adequate
てきど|適度|moderate
てきよう|適用|applying
できるだけ|出来るだけ|as much as possible
できれば||if possible
てじな|手品|trick, magic, juggling
ですから||therefore
てつ|鉄|iron
てつがく|哲学|philosophy
てつだい|手伝い|help, helper, assistant
てってい|徹底|thoroughness, completeness
てつどう|鉄道|railroad
てつや|徹夜|all night, sleepless night
てま|手間|time, labour
でも|でも|but, however
デモ||demo, demonstration
てんけい|典型|type, pattern, archetypal
てんこう|天候|weather
でんきゅう|電球|light bulb
でんごん|伝言|verbal message
でんし|電子|electron
でんしれんじ|電子レンジ|microwave oven
でんち|電池|battery, cell
テント||tent
でんとう|伝統|tradition, convention
てんねん|天然|nature, spontaneity
ど|度|degree; counter for occurrences
とい|問い|question, query
とう|党|party (political)
とう|塔|tower, pagoda
とうあん|答案|examination paper
どういつ|同一|identity, sameness, similarity
どうか|銅貨|copper coin
どうきゅうせい|同級生|Classmate
とうじ|当時|at that time, in those days
どうし|動詞|verb
どうじ|同時|simultaneous(ly), concurrent
どうしても||at any cost, no matter what
とうちゃく|到着|arrival
どうとく|道徳|morals
とうひょう|投票|voting, poll
どうよう|同様|identical, equal to
どうりょう|同僚|coworker, colleague, associate
どうろ|道路|road, highway
とお|十|10, ten
とおす|通す|to let pass, to overlook, to continue
とおり|通り|in accordance with ~, following ~|| ~ Street,~ Avenue
とおりすぎる|通り過ぎる|to pass, to pass through
とかい|都会|city
とき|時|(1) time, hour||(2) occasion, moment
とく|解く|to untie; to unfasten; to solve
どく|毒|poison, toxicant
とくい|得意|pride, triumph, prosperity
どくしょ|読書|reading
どくしん|独身|single, unmarried, celibate
とくちょう|特徴|feature, characteristic
どくとく|独特|peculiarity, uniqueness, characteristic
どくりつ|独立|independence; self-support
とける|解ける|to come untied, to come apart
どこか||somewhere, anywhere
ところが||however, while, even if
ところで||by the way
とざん|登山|mountain-climbing
とし|都市|city, municipal, urban
としつき|年月|months and years
としょ|図書|books
としより|年寄|old people, the aged
とじる|閉じる|to close (e.g. book, eyes), to shut
とたん|途端|just (now, at the moment, etc.)
とち|土地|plot of land, lot, soil
とつぜん|突然|abruptly, suddenly, unexpectedly
トップ||top
とどく|届く|to reach
とにかく||anyhow, anyway
とばす|飛ばす|to skip over, to omit
とびだす|飛び出す|to jump out, to rush out, to fly out
とめる|留める|to fasten, to turn off, to detain
とも|友|friend, companion, pal
ともに|共に|sharing with, participate in
どよう|土曜|Saturday
とら|虎|tiger
ドライブ||drive, trip by car, driving
トラック||(1) truck, (2) (running) track
ドラマ||drama
トランプ||playing cards (lit: trump)
とりあげる|取り上げる|to take up (a topic, complaint, etc)||to pick up, to take away
どりょく|努力|great effort, endeavour, effort
どれ|どれ|well, now, let me see
ドレス||dress
とれる|取れる|to come off, to be taken off||to be removed
どろ|泥|mud
とん||ton (usu. a metric ton, i.e. 1,000kg)
とんでもない||unexpected; absolutely not!
どんな||what, what kind of
どんなに||how, how much
トンネル||tunnel
な|名|name, reputation
ないよう|内容|contents, matter, detail
なお||still; yet
なか|仲|relation, relationship
ながす|流す|to drain, to float, to shed (blood, tears)
なかなか||very; considerably; easily
なかば|半ば|middle, half, halfway
なかま|仲間|company, fellow, colleague
ながめ|眺め|scene, view, outlook
ながめる|眺める|to view, to gaze at
ながれ|流れ|stream, current
ながれる|流れる|to stream, to flow, to be washed away
なし|無し|without
なぜなら||because
なぞ|謎|riddle, puzzle, enigma
なっとく|納得|consent, assent, understanding
など|等|etc., and the like
なな|七|seven
なに|何|what
なん|何|what
なにか|何か|something
なにも||nothing
なべ|鍋|saucepan, pot
なま|生|(1) draft (beer)||(2) raw, unprocessed
なまける|怠ける|to be idle, to neglect
なみ|波|wave
なみだ|涙|tear
なやむ|悩む|to be worried, to be troubled
なる|成る|to become
なわ|縄|rope, hemp
なんで|何で|Why?, What for?
なんでも|何でも|by all means, everything
なんとか|何とか|somehow, anyhow
にあう|似合う|to suit, to match, to become
におい|匂い|odour, scent, smell
にがて|苦手|poor (at), weak (in), dislike (of)
にぎる|握る|to grasp, to seize
にち|日|sun, sunshine, day
にちじょう|日常|ordinary, regular
にちよう|日曜|Sunday
にっこう|日光|sunlight
にっちゅう|日中|daytime, broad daylight
にっこり||smile sweetly, smile
にっぽん|日本|Japan
にほん|日本|Japan
にゅういん|入院|hospitalization
にゅうがく|入学|entry to school
にゅうじょう|入場|entrance, admission, entering
にゅうりょく|入力|input; (data) entry
にんき|人気|popularity; public favor
にんげん|人間|human being, man, person
ぬく|抜く|to extract, to draw out, to unplug
ぬける|抜ける|to come out, to fall out
ぬの|布|cloth
ぬれる|濡れる|to get wet
ね|根|root
ね|値|value, price, cost
ねがい|願い|desire, wish, request
ねがう|願う|to desire, to wish, to request
ねずみ|鼠|mouse, rat
ねだん|値段|price, cost
ねっしん|熱心|zeal, enthusiasm
ねったい|熱帯|tropics
ねっちゅう|熱中|enthusiasm, zeal, mania
ねんかん|年間|year
ねんげつ|年月|months and years
ねんじゅう|年中|whole year, always, everyday
ねんだい|年代|age, era, period
ねんれい|年齢|age, years
の|野|field
のう|能|being skilled in, nicely, properly
のうか|農家|farmer, farm family
のうぎょう|農業|agriculture
のうみん|農民|farmers, peasants
のうりょく|能力|ability, faculty
のき|軒|eaves
のこす|残す|to leave behind, to reserve
のこり|残り|residue, remaining, left-over
のせる|乗せる|to place on something, to take on board
のぞく|除く|to remove, to exclude, to except
のぞみ|望み|wish, desire, (a) hope
のぞむ|望む|to desire, to wish for
のち|後|afterwards, since then, in the future
ノック||(1) knock, (2) fungo (baseball)
のど|喉|throat
のばす|伸ばす|to lengthen, to stretch, to reach out
のびる|伸びる|to stretch, to extend
のべる|述べる|to state, to express, to mention
のぼる|昇る|to arise, to ascend, to go up
のんびり||carefree, at leisure
ば|場|place, field (physics)
パーセント||percent
はい|灰|ash
ばいう|梅雨|rainy season in Japan
バイオリン||violin
ハイキング||hiking
はいたつ|配達|delivery, distribution
パイプ||pipe, tube
はいゆう|俳優|actor, performer
パイロット||pilot
はか|墓|grave, tomb
ばか|馬鹿|fool, idiot
はかせ|博士|doctorate, PhD
はかる|計る|to measure, to weigh, to survey
はく|履く|to wear, to put on (lower body)
はく|吐く|to breathe out; to vomit
はくしゅ|拍手|clapping hands, applause
ばくだい|莫大|enormous, vast
ばくはつ|爆発|explosion, detonation, eruption
はくぶつかん|博物館|museum
はげしい|激しい|violent, vehement, intense
はさみ||scissors
はさん|破産|(personal) bankruptcy
はし|端|end, edge, tip
はじまり|始まり|origin, beginning
パス||path, pass (in games)
はずす|外す|to unfasten, to remove
パスポート||passport
はた|旗|flag
はだ|肌|skin
はだか|裸|naked, nude
はたけ|畑|field
はたち|二十|20 years old, 20th year
はたらき|働き|work, labor
バッグ||bag, bug
はっけん|発見|discovery, detection, finding
はっこう|発行|issue (publications)
はっしゃ|発車|departure of a vehicle
ばっする|罰する|to punish, to penalize
はったつ|発達|development, growth
ばったり||with a clash; with a thud;||unexpectedly (meeting someone)
はってん|発展|development, growth
はっぴょう|発表|announcement, publication
はつめい|発明|invention
はなしあう|話し合う|to discuss, to talk together
はなす|離す|to part, divide, separate
はなす|放す|to separate, to set free
はなれる|離れる|to be separated from, to go away
はね|羽|feather; wing
はば|幅|width, breadth
ははおや|母親|mother
はぶく|省く|to omit, to eliminate
ばめん|場面|scene, setting (e.g. of novel)
はら|腹|abdomen, belly, stomach
はら|原|field, plain, wilderness
はり|針|needle, hand (e.g. clock)
はる|張る|to stick, to paste
ばん|番|number (in a series)|| one's turn
バン||van (caravan)
はんい|範囲|extent, scope, range
はんこう|反抗|opposition, resistance
はんざい|犯罪|crime
ハンサム||handsome
はんだん|判断|judgement, decision
はで|派手|showy; loud; flashy
はんにん|犯人|offender, criminal
はんばい|販売|sale, selling, marketing
ひ|灯|light
ビール||beer
ひがい|被害|damage
ひかく|比較|comparison
ひく|轢く|to run somebody over with vehicle
ピクニック||picnic
ひげき|悲劇|tragedy
ひこう|飛行|aviation
ひざ|膝|knee, lap
ひじょう|非常|emergency, extraordinary, unusual
びじん|美人|beautiful person (woman)
ひたい|額|forehead, brow
びっくり||be surprised, be amazed
ひづけ|日付|date, dating
ひっし|必死|inevitable death, desperation, frantic
ぴったり||exactly, neatly, sharp
ひっぱる|引っ張る|to pull, to draw, to stretch, to drag
ひてい|否定|negation, denial, repudiation
ビデオ||video
ひとこと|一言|single word
ひとごみ|人込み|crowd of people
ひとしい|等しい|equal
ひとり|独り|alone, unmarried
ひとりひとり|一人一人|one by one, one at a time
ひはん|批判|criticism, judgement, comment
ひひょう|批評|criticism, review, commentary
ひみつ|秘密|secret, secrecy
びみょう|微妙|delicate, subtle
ひも|紐|string, cord
ひよう|費用|cost, expense
ひょう|表|table (e.g. Tab 1), chart
びょう|秒|second (60th min)
ひょうか|評価|valuation, estimation, assessment, evaluation
ひょうげん|表現|expression, presentation
ひょうじょう|表情|facial expression
びょうどう|平等|equality, impartiality, evenness
ひょうばん|評判|fame, reputation, popularity
ひょうめん|表面|surface, outside, face, appearance
ひろがる|広がる|to spread (out), to extend
ひん|品|thing, goods, dignity
びん|瓶|bottle
びん|便|flight; train trip||mail; letter
ピン||pin
ふ|不|un, non, negative prefix
ぶ|不|un, non, negative prefix
ぶ|無|nothing, naught, nil, zero
ぶ|分|dividing, part
ふあん|不安|anxiety, uneasiness, insecurity
ふうけい|風景|scenery
ふうふ|夫婦|married couple, husband and wife
ふえ|笛|flute, pipe
ふか|不可|wrong, bad, improper
ふかのう|不可能|impossible
ぶき|武器|weapon, arms
ふくそう|服装|garments
ふくむ|含む|to contain; to include
ふくろ|袋|bag, sack
ふこう|不幸|unhappiness, misfortune, death
ふし|節|tune, tone, knot, knob
ぶじ|無事|safety, peace, quietness
ふしぎ|不思議|mystery, curiosity
ふじゆう|不自由|disability, inconvenience, destitution
ふじん|夫人|wife, Mrs, madam
ふじん|婦人|woman, female
ふせい|不正|injustice, unfairness
ふせぐ|防ぐ|to defend, to protect, to prevent
ふそく|不足|insufficiency, shortage
ぶたい|舞台|stage (theatre)
ふたご|双子|twins, a twin
ふたたび|再び|again, once more
ふだん|普段|usually, habitually, ordinarily
ふち|縁|rim; brim; edge
ぶつ|打つ|to hit, to strike
ぶつかる|打つかる|to strike against, to collide with
ぶっか|物価|prices of commodities,||prices (in general)
ぶっしつ|物質|material, substance
ぶつり|物理|physics
ふで|筆|writing brush
ふと|ふと|suddenly, accidentally, unexpectedly
ふね|船|ship, boat, watercraft
ぶひん|部品|parts, components
ぶぶん|部分|portion, section, part
ふへい|不平|complaint, discontent, dissatisfaction
ふまん|不満|dissatisfaction, displeasure, discontent
ふよう|不要|unnecessary, unneeded
プラス||plus; addition
プラン||plan
ふり|不利|disadvantage, handicap, unfavorable
ふる|振る|to wave; to allocate (work)
ふるえる|震える|to shiver, to shake, to quake
ブレーキ||a brake
ふれる|触れる|to touch
ふろ|風呂|bath
プロ||professional
ぶん|分|dividing, part, segment
ぶん|文|sentence
ふんいき|雰囲気|atmosphere, mood, ambience
ぶんしょう|文章|essay, article, composition
ぶんせき|分析|analysis
ぶんめい|文明|civilization, culture
ぶんや|分野|field, sphere, realm
ぶんるい|分類|categorization, sorting
へい|塀|wall, fence
へいきん|平均|average, mean
へいわ|平和|peace, harmony
べつに|別に|(not) particularly, nothing
へらす|減らす|to decrease, to diminish
へる|減る|to decrease (in size or number)
ベルト||Belt for western clothes
へんか|変化|change; variation
ペンキ||(n) paint
べんきょう|勉強|study
へんこう|変更|change, modification, alteration
べんごし|弁護士|lawyer, attorney
ベンチ||bench
べんとう|弁当|box lunch
ほう|方|side
ほう|法|Act (law: the X Act)
ぼう|棒|pole, rod, stick
ぼうけん|冒険|risk, venture, adventure
ほうこう|方向|direction, course, way
ほうこく|報告|report
ほうせき|宝石|gem, jewel
ほうそう|放送|broadcast, broadcasting
ほうふ|豊富|abundance, wealth, plenty
ほうほう|方法|method, manner, way, means
ほうぼう|方々|persons, this and that||here and there, everywhere
ほうもん|訪問|call, visit
ほえる|吠える|to bark
ボーイ||boy
ボート||rowing boat
ホーム||(1) platform, (2) home
ボール||ball, bowl
ほか|他|other (esp. places and things)
ほか|外|other place, the rest
ほこり|誇り|pride
ほこり|埃|dust
ぼしゅう|募集|recruitment, taking applications||raising (funds)
ほしょう|保証|guarantee, assurance, warranty
ほぞん|保存|preservation, conservation
ほど|程|degree, extent, bounds, limit
ほどう|歩道|footpath, walkway, sidewalk
ほとけ|仏|Buddha, merciful person
ほね|骨|bone
ほのお|炎|flame
ほほ|頬|cheek (of face)
ほお|頬|cheek (of face)
ほぼ||almost, roughly, approximately
ほほえむ|微笑む|to smile
ほめる|褒める|to praise, to speak well
ほり|濠|moat
ほんと|本当|truth, reality
ほんとう|本当|truth, reality
ほんにん|本人|the person oneself
ほんもの|本物|genuine article
ぼんやり||absent-minded, block-head, dim
ま|間|space, room, time, pause
マーケット||market
マイク||mike
まいご|迷子|lost (stray) child
まかせる|任せる|to entrust to another, to leave to
まく|幕|curtain, bunting
まけ|負け|defeat, loss, losing (a game)
まご|孫|grandchild
まさか||by no means
まさに||correctly, surely
まじめ|真面目|diligent, serious, honest
ます|増す|to increase, to grow
まず|先ず|first (of all), to start with
まずしい|貧しい|poor, needy
マスター||master (e.g. arts, science)
ますます||increasingly, more and more
また|又|again, and
まだ|未だ|yet, still, more, besides
まち|街|town
まちがい|間違い|mistake
まつ|松|pine tree
まっか|真っ赤|deep red, flushed (of face)
まっすぐ|真っ直ぐ|straight (ahead), direct, upright
まったく|全く|really, entirely, completely
まつり|祭|festival, feast
まなぶ|学ぶ|to learn, to take lessons in
まね|真似|mimicry, imitation
まねく|招く|to invite
ママ||Mama
まめ|豆|beans, peas
まもる|守る|to protect, to obey, to guard
まる|丸|circle, perfection
まる|円|circle, money
まるい|丸い|round, circular, spherical
まるで||quite, entirely, completely
まわす|回す|to turn, to revolve
まわり|回り|circumference, surroundings
まんいち|万一|by some chance, if by any chance
まんぞく|満足|satisfaction
み|身|body, main part, oneself
み|実|fruit, content, good result
みおくり|見送り|seeing one off, farewell, escort
みかた|味方|friend, ally, supporter
みごと|見事|splendid, magnificent, admirable
ミス||miss (mistake, error, failure),Miss
みちる|満ちる|to be full; to rise (e.g. tide)
みつ|密|density; thickness
みとめる|認める|to recognize, to approve, to admit
みんな|皆|all, everyone, everybody
みまい|見舞い|enquiry, expression of sympathy
みやげ|土産|present, souvenir
みやこ|都|capital
みょう|妙|strange, unusual
みょうごにち|明後日|day after tomorrow
みらい|未来|future (life, tense)
みりょく|魅力|charm, fascination, glamour
みる|見る|to see, to watch
ミルク||milk
む|無|nothing, naught, zero
むかい|向かい|facing, opposite, across the street
むかえ|迎え|person sent to pick up an arrival
むく|向く|to face
むける|向ける|to turn towards, to point
むし|無視|disregard, ignore
むしば|虫歯|cavity, tooth decay
むしろ|寧ろ|rather, better, instead
むすぶ|結ぶ|to tie, to bind, to link
むだ|無駄|futility, uselessness
むちゅう|夢中|crazy about; obsessed with
むね|胸|breast, chest
むりょう|無料|free, no charge
め|芽|sprout
めいかく|明確|clear up, clarify, define
めいじる|命じる|to order, to command, to appoint
めいじん|名人|master, expert
めいれい|命令|order, command
めいわく|迷惑|trouble, bother, annoyance
めし|飯|(sl) meals, food
めったに|滅多に|rarely (with neg. verb), seldom
メモ||memorandum
めん|面|face, surface
めん|綿|cotton, padding
めんきょ|免許|license, permit
めんどう|面倒|trouble, difficulty, care
メンバー||member
もうしこむ|申し込む|to apply for, to make an application
もうしわけ|申し訳|apology, excuse
もうふ|毛布|blanket
もえる|燃える|to burn
もくてき|目的|purpose, goal, aim
もくひょう|目標|mark, objective, target
もくよう|木曜|Thursday
もじ|文字|letter (of alphabet), character
もしも||if
もちあげる|持ち上げる|to raise, to lift up, to flatter
もちいる|用いる|to use, to make use of
もちろん|勿論|of course, certainly, naturally
もっとも|最も|most, extremely
もっとも|尤も|but then; although; though
もと|元|(1) origin, original, (2) former
もと|基|basis
もと|素|prime
もどす|戻す|to put back, to return
もとづく|基づく|to be grounded on, to be based on
もとめる|求める|to seek, to demand, to want
もの|者|person
ものおと|物音|sounds
ものがたり|物語|tale, story, legend
ものごと|物事|things, everything
もよう|模様|pattern, figure, design
もらう|貰う|to receive
もんく|文句|phrase, complaint
やがて||before long, soon
やく|役|use, service, role, position
やく|約|approximately, about
やく|訳|translation
やくわり|役割|part, role, duties
やちん|家賃|rent
やっかい|厄介|trouble, burden, care, bother
やど|宿|inn, lodging
やとう|雇う|to employ, to hire
やね|屋根|roof
やはり||even so, as I thought
やぶる|破る|to tear, to violate, to defeat
やめる|辞める|to resign; to retire; to quit
やや||a little, partially, somewhat
ゆいいつ|唯一|only, sole, unique
ゆうき|勇気|courage, bravery
ゆうこう|有効|validity, availability, effectiveness
ゆうしゅう|優秀|superiority, excellence
ゆうしょう|優勝|overall victory, championship
ゆうじょう|友情|friendship, fellowship
ゆうじん|友人|friend
ゆうのう|有能|able, capable, efficient
ゆうびん|郵便|mail, postal service
ゆうべ|夕べ|evening
ユーモア||humor
ゆうり|有利|advantageous, profitable, lucrative
ゆか|床|floor
ゆかい|愉快|pleasant, happy
ゆしゅつ|輸出|export
ゆずる|譲る|to turn over, to assign, to hand over
ゆたか|豊か|abundant, wealthy, plentiful
ゆっくり||slowly, at ease
ゆにゅう|輸入|importation, import, introduction
ゆるす|許す|to permit, to allow, to approve
よ|夜|evening, night
よあけ|夜明け|dawn, daybreak
よう|様|appearing...; looking...;
よう|酔う|to get drunk
ようい|容易|easy, simple, plain
ようき|陽気|season, weather, cheerfulness
ようきゅう|要求|request, demand, requisition
ようじん|用心|care, precaution, caution
ようす|様子|aspect, state, appearance
ようするに|要するに|the point is .., in short ..
ようそ|要素|element
ようてん|要点|gist, main point
ようび|曜日|day of the week
ヨーロッパ||Europe
よき|予期|expectation, forecast
よこぎる|横切る|to cross, to traverse
よさん|予算|estimate, budget
よす|止す|to cease, to abolish, to resign
よそく|予測|prediction, estimation
ヨット||yacht
よなか|夜中|midnight, dead of night
よのなか|世の中|society, the world, the times
よぶん|余分|extra, excess, surplus
よほう|予報|forecast, prediction
よぼう|予防|prevention, precaution
よみ|読み|reading
よめ|嫁|bride, daughter-in-law
よゆう|余裕|margin, room, allowance
より||than; from; out of
よると||according to
よろこび|喜び|joy, delight, pleasure
よろしい|宜しい|(hon) good, all right, fine
よん|四|four
らい|来|next (year, etc.)
ライター||lighter, writer
らく|楽|comfort, ease
ラケット||paddle, racket
りえき|利益|profits, gains, interest
りかい|理解|understanding, comprehension
りく|陸|land; shore
りこう|利口|clever, sharp, intelligent
りこん|離婚|divorce
りそう|理想|ideal
りつ|率|rate, ratio, proportion, percentage
りっぱ|立派|splendid, elegant, legitimate
りゅうがく|留学|studying abroad
りゅうこう|流行|fashion; fad; vogue
りょう|量|quantity, amount, volume
りょうがえ|両替|change, money exchange
りょうきん|料金|fee, charge, fare
れい|例|instance, example, case
れい|礼|expression of gratitude
れいぎ|礼儀|manners, courtesy, etiquette
れいせい|冷静|calm, composure, coolness
れつ|列|queue, line, row
れっしゃ|列車|train (ordinary)
レポート||report, paper
れんしゅう|練習|practice
れんそう|連想|association (of ideas)
れんぞく|連続|serial, consecutive, continuity
ろうじん|老人|the aged, old person
ろうどう|労働|manual labor, toil, work
ロケット||locket, rocket
ろんじる|論じる|to argue, to discuss, to debate
ろんそう|論争|controversy, dispute
ろんぶん|論文|thesis, essay
わ|輪|ring, hoop, circle
ワイン||wine
わがまま||selfishness, egoism
わかれ|別れ|parting, separation, farewell
わき|脇|side
わける|分ける|to divide, to separate
わざと||on purpose
わずか|僅か|only, merely, a little
わた|綿|cotton
わだい|話題|topic, subject
わらい|笑い|laugh, laughter, smile
わり|割|rate; ratio;||unit of 10%; mixed with (of drinks)
わる|割る|to divide, to cut, to break
わるくち|悪口|abuse, insult
われわれ|我々|we
わん|湾|bay, gulf, inlet
